1111111..11111....1......1
1......1.1........1......1
1.....1..1........1......1
111111...11111....1......1
1.....1..1........1......1
1......1.1........1......1
1111111..11111....111111.11111


